ST##..S..T
#T##..###.
#T###E###E
#TE...###.
###T#####G
